NO ./texture/wall/mossy.xpm
EA ./texture/wall/purplestone.xpm
SO ./texture/wall/redbrick.xpm
WE ./texture/wall/wood.xpm

F 255,2,0
C 1,0,3
111111111111
111111111111111111111111
1111111111111111111111111111111111111111111
111111111000000000000000000000000000000001111111       
    100000000000000000000000000000000000100001111111111
    1000111111111111111111111111111111111111111  111111
    1000100000000001000000000111111111110000111
    1000100000000001000000000111111111110000111
    1000100000000001000000000000001111110000111                  1111111
    1000100000000001000000000000000001110000111                  1000011
    100010000000000100000N000000000000000000111                  1111111
    1000100000000000000000000000000000000000111         111
    1000111111111111111111111111111111110000111         101
    100011111111111111111111111111111111000011111111    111
   1100000000000000000011100000000000000000011110001
   100000000000000000011100000000000000000011 111111
   1111111111111111111111111111111111111111111
11111
    1111  
    1111
