NO ./texture/wall/mossy.xpm
EA ./texture/wall/purplestone.xpm
SO ./texture/wall/redbrick.xpm
WE ./texture/wall/wood.xpm

F 125,125,125
C 1,0,3

111111111111111111111111
1000000000S0000000000001
100000000000000000000001
100000000010000000000001
100000000010000000000001
100000000010000000000001
100000000010000000000001
100000000010000000000001
100000000010000000000001
100000000010000000000001
111000001111000000000111
100000000010000000000001
100000000010000000000001
100000000010000000000001
100000000010000000000001
100000000010000000000001
100000000010000000000001
100000000010000000000001
100000000010000000000001
100000000000000000000001
100000000000000000000001
100000000000000000000001
100000000000000000000001
100000000000000000000001
111111111111111111111111