NO ./texture/wall/mossy.xpm
EA ./texture/wall/purplestone.xpm
SO ./texture/wall/redbrick.xpm
WE ./texture/wall/wood.xpm
F 220,111,119
C 225,111,200





11111
10N01   1
10001
11111